1111111111
10P001C001
100C100001
100C1C1011
101C1C1001
1011111101
100C000001
1111011101
100C0001E1
1111111111
