111111111111111111
10000000000CCCCCC1
1P0000000C00000001
10000000000CCCCCC1
1C00000000000000E1
111111111111111111
