111111111
10001CCC1
1P00ECCC1
10001CCC1
111111111
